Все рубрики
HR специалисты - Бизнес-тренеры
IT
Автобизнес - Сервисное обслуживание
Административный персонал - Водители - Курьеры
Банки - Инвестиции - Лизинг
Бухгалтерия - Налоги - Финансы предприятия
Гостиницы - Рестораны - Кафе
Государственные учреждения - Местное самоуправление
Дизайн - Графика - Фото
Закупки - Снабжение
Консалтинг - Аналитика - Аудит
Культура - Шоу-бизнес - Развлечения
Логистика - Таможня - Склад
Маркетинг - Реклама - PR
Медиа - Издательское дело
Медицина - Фармацевтика - Здравоохранение
Морские специальности
Наука - Образование - Перевод
Недвижимость
Некоммерческие - Общественные организации
Охрана - Безопасность - Силовые структуры
Продажи - Клиент-менеджмент
Производство - Инженеры - Технологи
Рабочие специальности - Персонал для дома
Сельское хозяйство - Агробизнес - Лесное хозяйство
Спорт - Красота - Оздоровление
Страхование
Строительство - Архитектура
Студенты - Начало карьеры - Без опыта
Телекоммуникации - Связь
Топ-менеджмент - Директора
Торговля
Туризм - Путешествия
Юристы, адвокаты, нотариусы
